SIZE 8 8
TIME 30

BBBB BBBB BBBB BBBB BBBB BBBB BBBB BBBB
BBBB YYYY GGGG BBBB RRRR RRRR RRRR RRRR
BBBB YYYY GGGG BBBB RRRR BBBB BBBB RRRR
BBBB YYYY GGGG BBYB RBRB BBBB BBBB RRRR
BBBB YYYY GGGG BBBB RRRR BBBB BBBB RRRR
BBBB YYYY MCGG BBBB RRRR RRRR RRRR RRRR
BBBB YYYY GGBB BBBB BBBB BBBB BBBB BBBB
BBBB BBBB BBBB BBBB BBBB BBBB BBBB BBBB

PLAYER 0 0
FLYING 1 8 RIGHT
FOLLOWER 1 3 RIGHT R
SMART 5 7 LEFT

LOOT 1 4 DOLLAR
BOMB 4 5
SHIELD 6 7
LEVER 7 2 G
LEVER 8 8 C
GATE 5 5 R
GATE 2 8 G
CLOCK 4 4
DOOR 1 8

