SIZE 12 12
TIME 45

BBBB BBBB BBBB BBBB BBBB BBBB BBBB BBBB BBBB BBBB BBBB BBBB
BBBB YYYY BBBB BBBB RRRR BBBB BBBB BBBB GGGG GGGG GGGG BBBB
BBBB YYYY BBBB BBBB RRRR BBBB BBBB BBBB GGGG BBBB GGGG BBBB
BBBB YYYY BBBB BBBB RRRR BBBB RRRR RRRR GGGG BBBB GGGG BBBB
BBBB YYYY BBBB BBBB RRRR BBBB RRRR BBBB GGGG BBBB GGGG BBBB
BBBB YYYY BYBY RBRB RRRR RRRR RRRR BBBB GGGG BBBB GGGG BBBB
BBBB YYYY BBBB BBBB RRRR BBBB BBBB BBBB GBGB BBBB GGGG BBBB
BBBB YYYY BBBB BBBB RRRR BBBB BBBB BBBB GGGG BBBB GGGG BBBB
BBBB YYYY BBBB BBBB RRRR BBBB BBBB BBBB GGGG BBBB GGGG BBBB
BBBB YYYY BBBB BBBB RRRR BBBB BBBB BBBB GGGG BBBB GGGG BBBB
BBBB YYYY BBBB BBBB BBBB BBBB BBBB BBBB GGGG GGGG GGGG BBBB
BBBB BBBB BBBB BBBB BBBB BBBB BBBB BBBB BBBB BBBB BBBB BBBB

PLAYER 0 0
FLYING 1 7 RIGHT
FOLLOWER 2 2 RIGHT G
CAMPER 6 6 RIGHT

LOOT 1 1 DOLLAR
BOMB 5 11
SHIELD 6 7
LEVER 8 3 G
GATE 11 3 R
GATE 11 7 G
CLOCK 3 10
DOOR 11 2
LEVER 10 5 R


