SIZE 12 12
TIME 300

BBBB BBBB BBBB BBBB BBBB YYBB BBBB BBBB BBBB BBBB BBBB BBBB
BBBB BBBB BBBB BBBB BBBB YYYY BBBB BBBB BBBB BBBB BBBB BBBB
BBBB BBBB BBBB BBBB BBBB YYYY BBBB BBBB BBBB BBBB BBBB BBBB
BBBB BBBB BBBB BBBB BBBB YYYY BBBB BBBB BBBB BBBB BBBB BBBB
BBBB BBBB BBBB BBBB BBBB YYYY BBBB BBBB BBBB BBBB BBBB BBBB
BBBB BBBB BBBB BBBB BBBB YYYY BBBB BBBB BBBB BBBB BBBB BBBB
YYYY YYBB YYYY YYYY YYYY YYYY YYYY YYYY YYYY YYYY RRRR YYYY
BBBB BBBB BBBB BBBB BBBB YYYY BBBB BBBB BBBB BBBB BBBB BBBB
BBBB BBBB BBBB BBBB BBBB YYYY BBBB BBBB BBBB BBBB BBBB BBBB
BBBB BBBB BBBB BBBB BBBB YYYY BBBB BBBB BBBB BBBB BBBB BBBB
BBBB BBBB BBBB BBBB BBBB YYYY BBBB BBBB BBBB BBBB BBBB BBBB
BBBB BBBB BBBB BBBB BBBB YYYY BBBB BBBB BBBB BBBB BBBB BBBB

PLAYER 12 12
FOLLOWER 1 1 RIGHT B
FOLLOWER 2 6 DOWN R

BOMB 7 6
LOOT 2 6 CENT
LOOT 1 6 CENT
LOOT 3 6 CENT
LOOT 5 6 CENT
LOOT 7 9 RUBY
LOOT 7 10 RUBY
LOOT 7 11 RUBY
LOOT 7 12 RUBY
LOOT 7 5 RUBY
LOOT 7 4 RUBY
LOOT 7 3 RUBY
LEVER 12 6 B
DOOR 10 10
