SIZE 12 12
TIME 300

BBGG BBBB BBBB BBBB BBBB BBBB BBBB BBBB BBBB BBBB BBBB BBBB
BBBB BBBB BBBB BBBB BBBB BBBB BBBB BBBB BBBB BBBB BBBB BBBB
GGGG BBBB BBBB BBBB BBBB BBBB BBBB BBBB BBBB BBBB BBBB BBBB
BBBB BBBB BBBB BBBB BBBB BBBB BBBB BBBB BBBB BBBB BBBB BBBB
GGGG BBBB GGGG BBBB BBBB GGGG BBBB BBBB BBBB BBBB BBBB BBBB
BBBB BBBB BBBB BBBB BBBB BBBB BBBB BBBB BBBB BBBB BBBB BBBB
GGGG BBBB BBBB BBBB BBBB BBBB BBBB BBBB BBBB BBBB BBBB BBBB
BBBB BBBB BBBB BBBB BBBB BBBB BBBB BBBB BBBB BBBB BBBB BBBB
GGGG BBBB BBBB BBBB BBBB BBBB BBBB BBBB BBBB BBBB BBBB BBBB
BBBB BBBB BBBB BBBB BBBB BBBB BBBB BBBB BBBB BBBB BBBB BBBB
GGGG BBBB GGGG BBBB BBBB GGGG BBBB BBBB BBBB BBBB BBBB GGGG
GGGG BBBB GGGG BBBB BBBB GGGG BBBB BBBB BBBB BBBB BBBB GGGG

PLAYER 3 3
FLYING 2 5 RIGHT
SMART 1 1 UP

LOOT 12 11 CENT
DOOR 2 7

