SIZE 12 12
TIME 999

BCGC CCCC BBBB CCCC BBBB CCCC BBBB CCCC BBBB CCCC BBBB CCCC
GMRM MMMM GGGG MMMM GGGG MMMM GGGG MMMM GGGG MMMM GGGG MMMM
RYBY YYYY RRRR YYYY RRRR YYYY RRRR YYYY RRRR YYYY RRRR YYYY
BBBB BBBB BBBB BBBB BBBB BBBB BBBB BBBB BBBB BBBB BBBB BBBB
BBBB BBBB BBBB BBBB BBBB BBBB BBBB BBBB BBBB BBBB BBBB CCCC
BBBB BBBB BBBB BBBB BBBB BBBB BBBB BBBB BBBB BBBB BBBB BBBB
BBBB BBBB BBBB BBBB BBBB BBBB BBBB BBBB BBBB BBBB BBBB MMMM
BBBB BBBB BBBB BBBB BBBB BBBB BBBB BBBB BBBB BBBB BBBB BBBB
BBBB BBBB BBBB BBBB BBBB BBBB BBBB BBBB BBBB BBBB BBBB YYYY
BBBB BBBB BBBB BBBB BBBB BBBB BBBB BBBB BBBB BBBB BBBB BBBB
BBBB BBBB BBBB BBBB BBBB BBBB BBBB BBBB BBBB BBBB BBBB BBBB
BBBB BBBB BBBB BBBB BBBB BBBB BBBB BBBB BBBB BBBB BBBB BBBB

PLAYER 12 12
DOOR 1 1
