SIZE 12 12
TIME 40

YYYY CCCC CCCC BBBB BBBB BBBB YYYY GGGG BBBB BBBB BBBB CCCC
GGGG GGGG CCCC BBBB BBBB BBBB GGGG GGGG BBBB BBBB BBBB BBBB
BBBB BBBB BBBB BBBB BBBB BBBB GGGG GGGG BBBB BBBB BBBB BBBB
BBBB BBBB BBBB BBBB BBBB BBBB BBBB BBBB GGGG BBBB BBBB BBBB
BBBB BBBB BBBB BBBB BBBB CCCC CCCC CCCC GGGG BBBB BBBB BBBB
CRYG BBBB CCCC BBBB BBBB CCCC YYYY CCCC GGGG BBBB BBBB GGCC
BBBB BBBB BBBB BBBB BBBB CCCC CCCC CCCC GGGG BBBB BBBB BBBB
BBBB BBBB BBBB BBBB BBBB BBBB BBBB GGGG GGGG BBBB BBBB BBBB
RRRR RRRR RRRR BBBB BBBB BBBB YYRR BBBB BBBB BBBB BBBB BBBB
BBBB BBBB RRRR BBBB BBBB BBBB BBBB BBBB BBBB BBBB BBBB BBBB
MMMM MMMM RRRR BBBB YYBB BBBB BBBB BBBB BBBB BBBB BBBB BBBB
BBBB MMMM RRRR BBBB YMYM BBBB YYYY BBBB BBBB BBBB BBBB GYGY

PLAYER 11 0
FLYING 6 7 RIGHT
FOLLOWER 1 2 DOWN B
FOLLOWER 4 12 DOWN B
CAMPER 1 1 RIGHT
SMART 11 12 LEFT

DOOR 12 12
GATE 12 11 C
LEVER 1 12 C
GATE 10 12 M
LEVER 6 4 M
BOMB 9 1
LOOT 11 1 DOLLAR
LOOT 11 2 DOLLAR
LOOT 12 2 DOLLAR
CLOCK 5 10
CLOCK 5 11
CLOCK 5 12
CLOCK 6 10
CLOCK 6 11
CLOCK 6 12
LOOT 5 6 DOLLAR
LOOT 6 6 DOLLAR
LOOT 7 6 DOLLAR
LOOT 5 7 DOLLAR
LOOT 5 8 DOLLAR
LOOT 6 8 DOLLAR
LOOT 7 8 DOLLAR
LOOT 7 7 DOLLAR
LOOT 6 7 DIAMOND
LOOT 4 5 RUBY

