SIZE 12 12
TIME 999

BCGC CCCC BBBB CCCC BBBB CCCC BBBB CCCC BBBB CCCC BBBB CCCC
GMRM MMMM GGGG MMMM GGGG MMMM GGGG MMMM GGGG MMMM GGGG MMMM
RYBY YYYY RRRR YYYY RRRR YYYY RRRR YYYY RRRR YYYY RRRR YYYY
BBBB BBBB BBBB BBBB BBBB BBBB BBBB BBBB BBBB BBBB BBBB BBBB
BBBB BBBB BBBB BBBB BBBB BBBB BBBB BBBB BBBB BBBB BBBB CCCC
BBBB BBBB BBBB BBBB BBBB BBBB BBBB BBBB BBBB BBBB BBBB BBBB
BBBB BBBB BBBB BBBB BBBB BBBB BBBB BBBB BBBB BBBB BBBB MMMM
BBBB BBBB BBBB BBBB BBBB BBBB BBBB BBBB BBBB BBBB BBBB BBBB
BBBB BBBB BBBB BBBB BBBB BBBB BBBB BBBB BBBB BBBB BBBB YYYY
BBBB BBBB CCCC BBBB CCCC BBBB BBBB BBBB BBBB BBBB BBBB BBBB
BBBB BBBB BBBB BBBB BBBB BBBB BBBB BBBB BBBB BBBB BBBB BBBB
BBBB BBBB CCCC BBBB CCCC BBBB BBBB BBBB BBBB BBBB BBBB BBBB

PLAYER 10 7
SMART 10 1 RIGHT
FLYING 1 1 RIGHT
FOLLOWER 12 1 LEFT B
CAMPER 2 2 RIGHT

DOOR 7 5
LOOT 3 8 CENT
LOOT 4 8 DOLLAR
LOOT 5 8 RUBY
LOOT 6 8 DIAMOND
CLOCK 7 8
LEVER 8 8 C
GATE 1 12 C
BOMB 4 4


