SIZE 12 12
TIME 300

BBBB BBBB BBBB BBBB BBBB BBBB BBBB BBBB BBBB BBBB BBBB BBBB
BBBB BBBB BBBB BBBB BBBB BBBB BBBB BBBB BBBB BBBB BBBB BBBB
BBBB BBBB BBBB BBBB BBBB BBBB BBBB BBBB BBBB BBBB BBBB BBBB
BBBB BBBB BBBB BBBB BBBB BBBB BBBB BBBB BBBB BBBB BBBB BBBB
BBBB BBBB BBBB YYYY YYYY YYYY YYYY YYYY YYYY BBBB BBBB BBBB
BBBB BBBB BBBB YYYY BBBB BBBB BBBB BBBB YYYY BBBB BBBB BBBB
BBBB BBBB BBBB YYYY BBBB BBBB BBBB BBBB YYYY BBBB BBBB BBBB
BBBB BBBB BBBB YYYY YYYY YYYY YYYY YYYY YYYY BBBB BBBB BBBB
BBBB BBBB BBBB BBBB BBBB BBBB BBBB BBBB BBBB BBBB BBBB BBBB
BBBB BBBB BBBB BBBB BBBB BBBB BBBB BBBB BBBB BBBB BBBB BBBB
BBBB BBBB BBBB BBBB BBBB BBBB BBBB BBBB BBBB BBBB BBBB BBBB
BBBB BBBB BBBB BBBB BBBB BBBB BBBB BBBB BBBB BBBB BBBB BBBB

PLAYER 10 10
CAMPER 2 2 RIGHT

LOOT 12 12 DOLLAR
LOOT 9 2 RUBY
DOOR 6 6
GATE 6 5 R